{
    "layerExtent": [0.0, 0.0, 1000.0, 1000.0],
    "featureNames": ["district_borough_unitary_region.268", "district_borough_unitary_region.274", "district_borough_unitary_region.277", "district_borough_unitary_region.278", "district_borough_unitary_region.279", "district_borough_unitary_region.280", "district_borough_unitary_region.293", "district_borough_unitary_region.309", "district_borough_unitary_region.316", "district_borough_unitary_region.319", "district_borough_unitary_region.323", "district_borough_unitary_region.327", "district_borough_unitary_region.328", "district_borough_unitary_region.329", "district_borough_unitary_region.340", "district_borough_unitary_region.349", "district_borough_unitary_region.355", "district_borough_unitary_region.356", "district_borough_unitary_region.357", "district_borough_unitary_region.358", "district_borough_unitary_region.359", "district_borough_unitary_region.360"],
    "features": {
        "district_borough_unitary_region.268": {
            "shape": [
                [314, 716, 313, 720, 313, 721, 308, 721, 305, 721, 303, 722, 301, 721, 298, 721, 294, 720, 292, 723, 292, 724, 291, 724, 288, 724, 286, 725, 284, 724, 281, 724, 280, 722, 278, 721, 275, 721, 271, 720, 274, 720, 275, 716, 273, 713, 276, 711, 279, 709, 281, 706, 281, 705, 283, 704, 282, 702, 285, 703, 288, 705, 291, 707, 294, 706, 298, 705, 302, 704, 302, 700, 305, 698, 305, 697, 306, 695, 308, 692, 309, 690, 311, 689, 312, 687, 313, 685, 316, 687, 320, 686, 321, 688, 324, 690, 326, 693, 326, 694, 326, 697, 328, 698, 330, 699, 330, 702, 328, 705, 326, 707, 325, 710, 325, 713, 324, 713, 322, 714, 317, 714, 314, 716, 314, 716]
            ],
            "center": [301, 705],
            "bbox": [271, 685, 60, 40]
        },
        "district_borough_unitary_region.274": {
            "shape": [
                [407, 691, 407, 694, 405, 696, 403, 693, 403, 692, 402, 690, 400, 687, 398, 686, 396, 683, 395, 681, 398, 678, 404, 681, 409, 681, 414, 681, 414, 684, 416, 686, 420, 690, 419, 692, 419, 697, 418, 701, 415, 703, 416, 701, 415, 699, 413, 698, 410, 696, 407, 692, 407, 691]
            ],
            "center": [407, 690],
            "bbox": [395, 678, 25, 25]
        },
        "district_borough_unitary_region.277": {
            "shape": [
                [407, 741, 409, 742, 412, 744, 411, 748, 409, 751, 408, 751, 407, 751, 402, 751, 399, 753, 395, 752, 391, 753, 387, 754, 384, 754, 380, 753, 376, 752, 372, 751, 369, 751, 366, 751, 363, 749, 361, 746, 359, 743, 355, 741, 353, 738, 355, 737, 359, 736, 363, 735, 366, 735, 367, 735, 370, 733, 373, 731, 377, 732, 380, 732, 382, 733, 383, 733, 386, 731, 390, 732, 394, 733, 396, 734, 397, 738, 400, 740, 404, 739, 407, 740, 407, 741]
            ],
            "center": [382, 742],
            "bbox": [353, 731, 59, 23]
        },
        "district_borough_unitary_region.278": {
            "shape": [
                [399, 703, 397, 699, 396, 695, 394, 694, 393, 691, 392, 686, 395, 684, 397, 685, 399, 686, 400, 690, 402, 691, 403, 693, 405, 694, 407, 694, 406, 692, 409, 693, 411, 697, 413, 698, 415, 699, 416, 701, 417, 703, 419, 702, 422, 702, 423, 706, 421, 710, 422, 712, 423, 716, 423, 717, 421, 718, 420, 718, 417, 718, 419, 721, 420, 723, 419, 725, 417, 726, 414, 725, 410, 724, 406, 725, 403, 723, 400, 723, 400, 720, 397, 718, 396, 716, 395, 713, 395, 709, 397, 706, 398, 704, 399, 703]
            ],
            "center": [408, 704],
            "bbox": [392, 683, 32, 43]
        },
        "district_borough_unitary_region.279": {
            "shape": [
                [446, 711, 449, 710, 452, 710, 454, 713, 455, 715, 453, 716, 450, 718, 449, 720, 451, 723, 453, 724, 455, 729, 453, 730, 452, 730, 448, 731, 448, 733, 444, 731, 448, 730, 450, 729, 452, 728, 453, 726, 451, 727, 450, 728, 446, 730, 447, 728, 449, 727, 446, 729, 445, 729, 446, 729, 445, 729, 442, 729, 437, 729, 432, 731, 427, 732, 424, 734, 421, 733, 423, 730, 420, 728, 417, 726, 420, 724, 421, 722, 418, 720, 419, 718, 421, 719, 422, 717, 423, 717, 422, 715, 425, 715, 426, 715, 427, 715, 428, 713, 432, 714, 434, 713, 437, 713, 438, 713, 441, 713, 444, 713, 445, 712, 446, 711]
            ],
            "center": [436, 722],
            "bbox": [417, 709, 39, 26]
        },
        "district_borough_unitary_region.280": {
            "shape": [
                [327, 707, 328, 704, 330, 701, 330, 698, 328, 697, 326, 696, 326, 693, 325, 693, 323, 690, 322, 688, 321, 686, 324, 686, 326, 685, 325, 681, 326, 681, 328, 680, 333, 680, 335, 683, 338, 685, 338, 688, 341, 690, 343, 689, 345, 686, 350, 685, 352, 684, 356, 685, 359, 687, 361, 688, 361, 691, 362, 696, 361, 701, 362, 704, 364, 707, 362, 708, 358, 709, 354, 708, 351, 710, 350, 714, 350, 715, 348, 718, 351, 720, 352, 722, 353, 726, 349, 727, 347, 728, 344, 728, 342, 727, 340, 726, 338, 725, 336, 722, 333, 720, 333, 717, 330, 715, 328, 714, 325, 714, 325, 711, 327, 707, 327, 707]
            ],
            "center": [342, 704],
            "bbox": [320, 680, 44, 48]
        },
        "district_borough_unitary_region.293": {
            "shape": [
                [382, 480, 379, 482, 377, 483, 373, 482, 369, 483, 366, 481, 364, 478, 365, 476, 364, 476, 360, 477, 356, 478, 352, 480, 348, 481, 346, 484, 340, 485, 337, 483, 334, 479, 331, 477, 331, 474, 327, 473, 325, 474, 321, 475, 319, 473, 319, 470, 321, 467, 321, 464, 320, 462, 318, 461, 317, 459, 316, 457, 319, 455, 317, 454, 320, 451, 323, 448, 325, 443, 327, 440, 322, 436, 319, 435, 317, 431, 320, 431, 323, 431, 323, 432, 327, 430, 331, 429, 333, 428, 335, 427, 337, 426, 338, 426, 339, 428, 340, 428, 339, 426, 335, 425, 335, 424, 338, 424, 335, 422, 334, 420, 337, 418, 339, 419, 341, 422, 345, 421, 349, 422, 351, 425, 353, 426, 357, 427, 362, 427, 365, 427, 369, 426, 373, 425, 377, 423, 378, 423, 378, 426, 378, 427, 376, 430, 376, 433, 375, 435, 377, 436, 380, 438, 382, 441, 382, 444, 381, 448, 381, 451, 377, 451, 374, 453, 372, 456, 371, 458, 369, 461, 366, 463, 369, 462, 371, 462, 376, 462, 377, 464, 379, 466, 381, 469, 379, 470, 379, 473, 380, 474, 381, 476, 382, 478, 382, 480]
            ],
            "center": [349, 451],
            "bbox": [316, 418, 66, 67]
        },
        "district_borough_unitary_region.309": {
            "shape": [
                [391, 705, 389, 702, 387, 699, 385, 696, 383, 693, 380, 690, 380, 689, 382, 686, 379, 683, 380, 679, 382, 676, 384, 680, 387, 680, 390, 682, 391, 684, 393, 688, 395, 692, 396, 694, 397, 696, 398, 700, 398, 704, 397, 706, 395, 709, 393, 708, 391, 705]
            ],
            "center": [388, 692],
            "bbox": [378, 676, 21, 33]
        },
        "district_borough_unitary_region.316": {
            "shape": [
                [339, 727, 341, 726, 343, 727, 345, 728, 349, 727, 351, 726, 353, 723, 352, 721, 349, 719, 348, 715, 350, 714, 350, 711, 352, 708, 356, 709, 360, 709, 364, 709, 367, 709, 369, 710, 371, 713, 372, 715, 375, 717, 373, 720, 374, 724, 375, 726, 374, 729, 371, 731, 368, 733, 367, 735, 365, 734, 362, 736, 357, 736, 354, 738, 350, 737, 347, 737, 344, 737, 342, 734, 340, 731, 339, 727]
            ],
            "center": [357, 723],
            "bbox": [339, 708, 37, 30]
        },
        "district_borough_unitary_region.319": {
            "shape": [
                [342, 672, 345, 670, 347, 667, 345, 663, 347, 660, 347, 657, 349, 656, 349, 653, 349, 650, 352, 648, 352, 645, 355, 642, 354, 640, 352, 637, 352, 635, 349, 633, 346, 631, 348, 628, 344, 627, 344, 624, 344, 621, 344, 616, 344, 613, 344, 610, 345, 607, 344, 605, 346, 602, 348, 601, 348, 599, 347, 597, 345, 594, 346, 592, 350, 590, 351, 590, 353, 589, 356, 589, 354, 586, 351, 584, 350, 581, 350, 578, 347, 576, 345, 573, 343, 570, 344, 567, 347, 565, 348, 561, 344, 562, 341, 564, 338, 566, 336, 563, 334, 560, 334, 559, 335, 555, 334, 553, 330, 552, 327, 552, 325, 551, 326, 549, 328, 548, 330, 549, 332, 546, 335, 544, 334, 542, 336, 539, 335, 537, 337, 534, 340, 532, 344, 533, 347, 531, 351, 532, 353, 530, 355, 529, 358, 530, 362, 529, 364, 526, 366, 523, 366, 520, 365, 517, 364, 513, 365, 509, 368, 508, 369, 506, 373, 505, 377, 504, 379, 501, 387, 500, 391, 497, 395, 496, 399, 498, 401, 500, 405, 501, 407, 500, 409, 499, 411, 496, 414, 496, 417, 496, 419, 497, 418, 499, 420, 502, 417, 504, 417, 507, 416, 509, 416, 511, 417, 513, 420, 515, 424, 514, 424, 515, 426, 518, 427, 518, 430, 518, 432, 519, 434, 520, 432, 521, 436, 522, 438, 524, 439, 526, 438, 526, 435, 526, 432, 526, 432, 529, 429, 531, 430, 534, 429, 538, 427, 539, 427, 540, 425, 543, 424, 547, 421, 549, 418, 549, 419, 551, 420, 555, 419, 557, 420, 559, 422, 558, 425, 558, 424, 556, 426, 555, 429, 553, 432, 551, 435, 553, 435, 556, 433, 560, 430, 562, 430, 563, 426, 564, 421, 564, 417, 565, 414, 567, 410, 568, 409, 570, 406, 572, 407, 576, 410, 578, 412, 579, 415, 581, 418, 583, 421, 585, 424, 587, 427, 589, 431, 590, 433, 589, 438, 589, 439, 591, 438, 593, 434, 594, 434, 597, 432, 600, 433, 602, 436, 602, 440, 603, 437, 605, 435, 604, 432, 604, 429, 606, 428, 608, 425, 610, 425, 613, 423, 614, 422, 616, 421, 618, 419, 621, 423, 622, 425, 623, 421, 624, 417, 625, 417, 628, 421, 629, 420, 631, 419, 635, 419, 638, 422, 640, 422, 643, 423, 646, 424, 650, 424, 654, 422, 655, 422, 658, 423, 662, 425, 663, 427, 666, 428, 668, 425, 670, 424, 672, 422, 675, 419, 677, 417, 677, 416, 679, 412, 680, 407, 680, 401, 679, 396, 680, 395, 684, 390, 684, 389, 681, 387, 681, 384, 679, 382, 677, 379, 679, 376, 678, 374, 681, 371, 683, 368, 684, 367, 686, 364, 688, 361, 690, 360, 688, 358, 687, 355, 685, 353, 684, 349, 685, 344, 686, 343, 690, 341, 689, 339, 688, 337, 685, 335, 682, 338, 680, 339, 676, 341, 673, 342, 672]
            ],
            "center": [382, 592],
            "bbox": [325, 495, 115, 195]
        },
        "district_borough_unitary_region.323": {
            "shape": [
                [376, 677, 379, 680, 380, 684, 382, 688, 378, 689, 381, 692, 383, 695, 386, 697, 388, 700, 390, 703, 392, 706, 394, 707, 395, 712, 396, 715, 397, 717, 399, 720, 400, 722, 402, 723, 402, 726, 399, 726, 396, 726, 394, 725, 392, 728, 391, 728, 391, 731, 387, 732, 384, 732, 382, 733, 381, 733, 379, 732, 375, 731, 372, 731, 374, 728, 376, 726, 374, 723, 374, 720, 375, 716, 372, 714, 370, 713, 368, 710, 366, 709, 364, 706, 362, 703, 362, 700, 362, 695, 361, 690, 364, 688, 367, 686, 368, 684, 371, 683, 374, 681, 376, 678, 376, 677]
            ],
            "center": [382, 705],
            "bbox": [361, 677, 42, 57]
        },
        "district_borough_unitary_region.327": {
            "shape": [
                [366, 462, 369, 460, 371, 457, 372, 455, 375, 453, 378, 451, 381, 450, 381, 447, 382, 443, 382, 440, 379, 438, 377, 437, 374, 435, 376, 432, 376, 429, 378, 426, 378, 425, 377, 423, 381, 420, 386, 420, 389, 418, 392, 418, 395, 418, 393, 421, 391, 422, 391, 425, 392, 425, 392, 426, 393, 427, 395, 428, 397, 431, 396, 433, 395, 435, 398, 437, 398, 438, 400, 439, 400, 442, 400, 443, 402, 446, 404, 449, 405, 451, 409, 452, 413, 451, 415, 454, 415, 458, 416, 460, 419, 462, 419, 465, 421, 466, 419, 470, 420, 474, 419, 477, 419, 480, 421, 481, 422, 483, 425, 483, 423, 485, 421, 486, 417, 487, 413, 488, 408, 487, 405, 487, 402, 487, 399, 487, 397, 489, 394, 491, 393, 494, 391, 497, 387, 500, 379, 501, 379, 498, 379, 495, 381, 492, 378, 490, 380, 487, 382, 484, 384, 481, 382, 478, 381, 476, 380, 474, 379, 473, 379, 470, 381, 469, 379, 466, 377, 464, 376, 462, 371, 462, 369, 462, 366, 463, 366, 462]
            ],
            "center": [395, 459],
            "bbox": [366, 417, 59, 84]
        },
        "district_borough_unitary_region.328": {
            "shape": [
                [264, 691, 260, 692, 262, 689, 263, 689, 260, 691, 256, 692, 251, 691, 246, 690, 241, 690, 236, 690, 236, 687, 237, 685, 234, 683, 235, 681, 237, 678, 238, 676, 236, 675, 235, 673, 232, 673, 230, 672, 227, 670, 229, 667, 228, 663, 227, 661, 229, 658, 230, 658, 233, 656, 236, 658, 237, 657, 240, 655, 243, 656, 245, 655, 248, 653, 250, 652, 254, 651, 255, 647, 253, 646, 251, 643, 248, 641, 248, 640, 248, 639, 248, 637, 248, 636, 252, 637, 254, 638, 257, 639, 258, 639, 260, 638, 264, 639, 266, 640, 269, 640, 272, 640, 276, 639, 279, 637, 282, 639, 283, 639, 285, 640, 287, 637, 290, 635, 292, 636, 294, 633, 296, 632, 297, 630, 299, 631, 301, 630, 303, 629, 305, 628, 307, 627, 309, 628, 312, 630, 315, 628, 318, 626, 321, 624, 323, 625, 325, 626, 329, 624, 332, 624, 335, 626, 338, 628, 339, 630, 341, 627, 344, 627, 348, 628, 346, 631, 349, 633, 352, 635, 352, 637, 354, 640, 355, 642, 352, 645, 352, 648, 349, 650, 349, 653, 349, 656, 347, 657, 347, 660, 345, 663, 347, 667, 345, 670, 342, 672, 339, 674, 338, 678, 336, 681, 334, 682, 331, 680, 326, 680, 325, 680, 326, 682, 326, 687, 322, 686, 319, 686, 315, 687, 312, 685, 311, 687, 310, 689, 308, 690, 307, 692, 306, 696, 306, 697, 304, 698, 302, 701, 301, 704, 297, 705, 294, 707, 290, 707, 287, 705, 285, 702, 283, 701, 285, 700, 281, 701, 278, 703, 275, 703, 274, 703, 272, 702, 269, 699, 266, 697, 266, 694, 266, 697, 265, 695, 265, 694, 264, 696, 264, 693, 263, 693, 264, 695, 262, 694, 260, 695, 260, 692, 264, 691]
            ],
            "center": [291, 665],
            "bbox": [226, 623, 130, 84]
        },
        "district_borough_unitary_region.329": {
            "shape": [
                [404, 421, 405, 423, 407, 423, 406, 421, 407, 421, 408, 421, 409, 421, 410, 421, 414, 422, 418, 426, 422, 430, 424, 433, 427, 435, 432, 435, 435, 437, 438, 440, 442, 442, 444, 445, 444, 449, 441, 451, 438, 451, 439, 453, 438, 456, 435, 458, 433, 460, 432, 462, 430, 463, 427, 463, 424, 465, 420, 466, 419, 464, 419, 461, 416, 459, 415, 457, 415, 453, 412, 451, 408, 452, 404, 451, 404, 448, 402, 445, 401, 443, 399, 442, 401, 439, 398, 437, 397, 437, 394, 435, 397, 433, 397, 430, 395, 427, 392, 428, 392, 427, 391, 425, 390, 425, 391, 423, 394, 421, 394, 418, 397, 416, 401, 417, 403, 419, 402, 419, 404, 421]
            ],
            "center": [417, 441],
            "bbox": [390, 416, 55, 50]
        },
        "district_borough_unitary_region.340": {
            "shape": [
                [420, 711, 423, 708, 423, 703, 420, 703, 418, 702, 419, 698, 419, 693, 419, 690, 417, 687, 417, 684, 421, 685, 425, 686, 426, 689, 427, 691, 429, 692, 428, 696, 431, 696, 433, 697, 433, 700, 433, 701, 435, 702, 435, 705, 432, 705, 435, 708, 436, 712, 434, 713, 433, 713, 429, 714, 426, 714, 426, 715, 426, 716, 423, 714, 420, 712, 420, 711]
            ],
            "center": [426, 700],
            "bbox": [415, 684, 22, 32]
        },
        "district_borough_unitary_region.349": {
            "shape": [
                [391, 496, 394, 493, 395, 491, 397, 490, 400, 487, 403, 487, 406, 487, 409, 487, 413, 487, 418, 487, 422, 486, 424, 484, 424, 483, 423, 483, 422, 481, 419, 479, 418, 477, 420, 473, 420, 469, 422, 466, 425, 464, 428, 464, 432, 463, 433, 463, 435, 459, 436, 457, 440, 456, 443, 458, 447, 459, 450, 458, 448, 460, 448, 463, 450, 464, 452, 467, 451, 469, 451, 470, 451, 471, 453, 472, 453, 475, 454, 477, 455, 479, 459, 480, 460, 480, 461, 480, 464, 480, 467, 482, 467, 485, 468, 487, 467, 489, 468, 491, 464, 492, 461, 494, 459, 497, 457, 494, 455, 491, 454, 489, 450, 488, 447, 488, 443, 489, 440, 487, 439, 485, 438, 485, 436, 486, 433, 488, 433, 489, 430, 491, 429, 490, 425, 491, 423, 492, 422, 496, 418, 497, 417, 495, 413, 496, 411, 497, 409, 500, 407, 501, 404, 501, 401, 499, 398, 498, 394, 496, 391, 496]
            ],
            "center": [429, 478],
            "bbox": [391, 456, 77, 45]
        },
        "district_borough_unitary_region.355": {
            "shape": [
                [249, 422, 252, 422, 254, 423, 253, 419, 253, 418, 254, 416, 255, 414, 256, 412, 255, 408, 255, 407, 254, 407, 255, 405, 257, 406, 259, 405, 261, 404, 262, 404, 261, 404, 264, 404, 266, 403, 268, 404, 270, 403, 272, 402, 274, 403, 275, 403, 278, 403, 278, 404, 280, 405, 284, 404, 287, 404, 287, 405, 289, 408, 290, 410, 290, 413, 293, 415, 293, 416, 295, 419, 296, 421, 298, 422, 302, 423, 306, 422, 307, 422, 311, 423, 314, 423, 314, 424, 313, 426, 311, 429, 308, 433, 305, 435, 302, 437, 298, 438, 295, 440, 294, 444, 291, 446, 288, 448, 286, 449, 286, 450, 285, 450, 283, 451, 281, 452, 280, 454, 276, 453, 276, 452, 275, 452, 276, 452, 274, 451, 271, 451, 270, 449, 267, 447, 267, 446, 264, 444, 263, 444, 261, 443, 261, 440, 261, 439, 259, 436, 259, 435, 256, 433, 253, 433, 250, 433, 248, 432, 249, 430, 248, 430, 247, 428, 248, 428, 247, 426, 246, 426, 244, 425, 242, 426, 240, 425, 241, 425, 240, 423, 240, 422, 241, 420, 244, 420, 248, 419, 247, 419, 247, 420, 247, 421, 248, 421, 249, 421, 249, 422],
                [316, 423, 318, 422, 316, 423],
                [250, 403, 250, 402, 250, 403],
                [291, 409, 294, 415],
                [300, 438, 299, 438],
                [270, 401],
                [257, 403]
            ],
            "center": [278, 427],
            "bbox": [239, 401, 79, 53]
        },
        "district_borough_unitary_region.356": {
            "shape": [
                [382, 480, 383, 482, 381, 485, 379, 488, 380, 490, 380, 493, 378, 496, 380, 499, 378, 502, 376, 505, 371, 505, 368, 507, 367, 507, 365, 511, 365, 514, 365, 518, 365, 521, 365, 524, 364, 528, 360, 529, 356, 530, 354, 530, 352, 532, 349, 532, 346, 532, 342, 533, 338, 532, 336, 535, 335, 537, 335, 540, 335, 543, 334, 545, 331, 547, 330, 549, 327, 549, 326, 549, 325, 553, 321, 552, 318, 552, 316, 555, 313, 555, 310, 554, 307, 554, 306, 552, 305, 550, 304, 546, 302, 543, 302, 540, 303, 536, 304, 534, 307, 532, 310, 530, 310, 527, 309, 525, 309, 524, 309, 524, 308, 520, 306, 517, 304, 514, 301, 512, 299, 509, 301, 506, 303, 505, 303, 502, 302, 498, 300, 495, 299, 493, 296, 491, 292, 490, 288, 491, 283, 491, 280, 493, 277, 493, 272, 493, 271, 495, 266, 496, 263, 498, 263, 501, 260, 503, 260, 504, 259, 506, 261, 509, 257, 510, 254, 512, 253, 508, 252, 506, 250, 506, 248, 505, 246, 504, 244, 507, 240, 508, 237, 508, 234, 508, 231, 510, 230, 510, 228, 509, 228, 508, 230, 505, 231, 503, 233, 500, 232, 500, 233, 498, 236, 498, 238, 495, 240, 493, 241, 491, 243, 490, 246, 488, 249, 486, 252, 484, 251, 484, 253, 485, 255, 485, 259, 484, 261, 481, 263, 480, 264, 478, 267, 476, 269, 475, 272, 473, 275, 471, 278, 468, 279, 464, 280, 462, 279, 458, 278, 456, 281, 454, 283, 453, 287, 451, 289, 448, 292, 446, 295, 444, 296, 440, 299, 438, 302, 438, 305, 436, 308, 434, 308, 435, 309, 435, 309, 434, 310, 432, 311, 432, 313, 431, 313, 428, 316, 430, 318, 433, 321, 435, 326, 439, 327, 443, 324, 446, 321, 450, 318, 452, 319, 455, 317, 456, 317, 459, 318, 459, 318, 462, 320, 463, 322, 466, 320, 469, 320, 472, 320, 474, 323, 474, 326, 474, 330, 473, 331, 475, 333, 478, 336, 481, 338, 485, 344, 484, 347, 482, 350, 480, 355, 479, 359, 478, 362, 476, 366, 475, 365, 477, 365, 480, 367, 483, 372, 483, 375, 483, 378, 483, 381, 481, 382, 480],
                [223, 516, 225, 513, 226, 515, 223, 516],
                [263, 508, 262, 510],
                [236, 510, 236, 511],
                [223, 515, 230, 511]
            ],
            "center": [303, 492],
            "bbox": [223, 428, 161, 128]
        },
        "district_borough_unitary_region.357": {
            "shape": [
                [407, 741, 404, 738, 401, 740, 398, 738, 396, 735, 394, 732, 391, 732, 390, 728, 392, 727, 394, 726, 396, 725, 399, 725, 402, 727, 405, 725, 409, 724, 413, 725, 417, 725, 419, 726, 421, 729, 422, 731, 422, 735, 420, 736, 417, 739, 415, 742, 414, 742, 412, 743, 409, 743, 408, 741, 407, 741],
                [417, 755, 416, 755, 416, 754, 417, 754, 417, 755]
            ],
            "center": [406, 739],
            "bbox": [390, 724, 33, 31]
        },
        "district_borough_unitary_region.358": {
            "shape": [
                [332, 624, 329, 624, 325, 626, 323, 625, 321, 624, 318, 626, 315, 628, 312, 630, 309, 628, 307, 627, 305, 628, 303, 629, 301, 630, 299, 631, 297, 630, 296, 632, 294, 633, 292, 636, 290, 635, 287, 637, 285, 640, 283, 639, 282, 639, 279, 637, 276, 639, 272, 640, 269, 640, 266, 640, 264, 639, 260, 638, 258, 639, 257, 639, 254, 638, 252, 637, 248, 636, 248, 637, 246, 635, 242, 634, 238, 635, 237, 633, 236, 633, 234, 634, 232, 633, 233, 631, 232, 629, 232, 626, 232, 623, 233, 623, 234, 623, 237, 621, 242, 621, 243, 621, 245, 620, 247, 621, 251, 622, 255, 620, 258, 618, 259, 616, 260, 616, 261, 616, 264, 614, 267, 612, 269, 609, 272, 610, 276, 609, 280, 607, 283, 605, 286, 603, 289, 601, 292, 599, 294, 596, 295, 594, 298, 592, 299, 590, 301, 587, 302, 583, 303, 581, 305, 578, 304, 576, 305, 574, 306, 570, 308, 567, 310, 564, 309, 560, 309, 555, 313, 555, 316, 555, 318, 552, 321, 552, 325, 553, 327, 552, 329, 551, 333, 552, 335, 555, 335, 558, 334, 560, 335, 562, 337, 565, 340, 565, 343, 563, 346, 561, 347, 563, 346, 567, 344, 568, 344, 572, 347, 574, 349, 577, 350, 579, 351, 582, 353, 585, 355, 588, 353, 589, 351, 590, 350, 590, 347, 591, 345, 594, 347, 595, 347, 598, 350, 601, 346, 602, 345, 604, 344, 606, 345, 608, 345, 612, 345, 615, 344, 619, 345, 623, 343, 626, 341, 629, 338, 629, 337, 627, 334, 625, 332, 624],
                [231, 622, 232, 622, 231, 622]
            ],
            "center": [293, 596],
            "bbox": [231, 551, 125, 90]
        },
        "district_borough_unitary_region.359": {
            "shape": [
                [446, 711, 445, 712, 443, 713, 439, 714, 438, 712, 435, 710, 433, 706, 434, 704, 435, 704, 435, 701, 432, 701, 434, 698, 432, 697, 429, 697, 429, 694, 427, 691, 426, 689, 426, 687, 423, 685, 419, 684, 414, 684, 414, 681, 415, 679, 418, 677, 420, 677, 422, 674, 425, 672, 426, 670, 428, 667, 427, 665, 426, 663, 423, 661, 422, 657, 422, 654, 424, 653, 427, 653, 430, 656, 432, 659, 434, 662, 436, 663, 439, 665, 440, 665, 443, 663, 446, 661, 448, 662, 451, 662, 450, 664, 451, 663, 454, 665, 456, 668, 460, 669, 459, 673, 462, 675, 465, 677, 466, 675, 468, 676, 470, 677, 474, 678, 473, 680, 471, 683, 472, 686, 472, 690, 472, 693, 470, 696, 472, 699, 471, 701, 473, 704, 470, 706, 472, 707, 472, 710, 473, 714, 471, 719, 468, 721, 465, 724, 463, 727, 462, 729, 460, 730, 458, 729, 459, 728, 458, 728, 457, 728, 458, 730, 457, 728, 457, 731, 456, 729, 455, 731, 454, 731, 454, 729, 456, 728, 453, 724, 451, 723, 449, 720, 450, 718, 453, 716, 455, 715, 454, 713, 452, 710, 449, 710, 446, 711],
                [458, 730]
            ],
            "center": [444, 692],
            "bbox": [414, 652, 61, 80]
        },
        "district_borough_unitary_region.360": {
            "shape": [
                [182, 693, 180, 690, 178, 691, 178, 692, 175, 692, 174, 692, 172, 691, 171, 691, 172, 693, 172, 696, 170, 697, 169, 695, 168, 695, 169, 693, 168, 693, 166, 690, 164, 689, 161, 687, 166, 687, 167, 685, 169, 684, 172, 682, 174, 681, 176, 682, 179, 680, 179, 675, 178, 671, 177, 667, 173, 666, 169, 665, 168, 665, 166, 664, 163, 664, 162, 664, 159, 664, 157, 665, 155, 666, 155, 665, 155, 662, 157, 661, 155, 658, 158, 656, 161, 657, 161, 656, 162, 656, 163, 656, 164, 654, 168, 653, 168, 652, 170, 651, 173, 651, 174, 651, 175, 651, 175, 650, 176, 650, 176, 649, 177, 649, 180, 649, 183, 647, 184, 645, 183, 645, 183, 644, 184, 641, 183, 641, 184, 639, 186, 638, 187, 638, 187, 639, 188, 638, 189, 638, 190, 638, 192, 639, 193, 639, 196, 641, 194, 642, 196, 643, 197, 643, 200, 643, 202, 642, 204, 641, 204, 640, 205, 638, 207, 639, 207, 640, 212, 640, 212, 637, 213, 635, 217, 634, 221, 633, 223, 630, 224, 628, 225, 626, 227, 625, 229, 626, 231, 625, 232, 627, 233, 631, 233, 632, 234, 634, 236, 633, 236, 632, 237, 634, 241, 635, 244, 635, 247, 638, 248, 639, 248, 640, 249, 642, 251, 645, 254, 647, 255, 649, 253, 652, 249, 653, 247, 654, 244, 656, 241, 655, 239, 656, 237, 658, 234, 658, 232, 657, 230, 658, 228, 659, 226, 662, 228, 665, 229, 669, 228, 671, 231, 673, 232, 673, 235, 675, 236, 675, 238, 676, 236, 679, 236, 682, 236, 683, 236, 686, 236, 689, 234, 690, 230, 691, 228, 694, 229, 696, 227, 699, 227, 702, 226, 704, 223, 704, 221, 703, 220, 705, 216, 706, 214, 705, 210, 704, 207, 706, 206, 706, 206, 705, 205, 707, 203, 707, 202, 709, 200, 710, 199, 712, 196, 712, 194, 711, 194, 710, 191, 709, 191, 710, 187, 709, 185, 708, 184, 706, 184, 705, 183, 703, 183, 702, 180, 700, 179, 700, 179, 699, 176, 699, 176, 698, 177, 696, 177, 695, 180, 696, 183, 698, 185, 695, 190, 695, 193, 697, 194, 697, 196, 694, 200, 693, 202, 694, 205, 692, 205, 691, 204, 687, 205, 683, 202, 683, 204, 684, 203, 688, 205, 691, 202, 693, 199, 693, 195, 694, 192, 694, 188, 693, 187, 693, 185, 694, 183, 693, 182, 693],
                [156, 688, 155, 688, 154, 688, 154, 687, 155, 685, 158, 687, 158, 688, 158, 687, 156, 688, 156, 688],
                [151, 666, 150, 666, 150, 665, 151, 663, 152, 663, 153, 663, 153, 664, 153, 665, 152, 667, 151, 667, 151, 666],
                [229, 706, 229, 707, 228, 707, 226, 706, 224, 705, 228, 706, 229, 706],
                [159, 693, 157, 694, 159, 693],
                [133, 687, 134, 687, 134, 686, 134, 687, 133, 687],
                [160, 687, 159, 687, 160, 687],
                [151, 668, 151, 667, 147, 658, 145, 662],
                [157, 665, 156, 665, 156, 666, 156, 665, 157, 665],
                [145, 659, 146, 659, 145, 659],
                [177, 695],
                [144, 665, 145, 665, 144, 665],
                [168, 666],
                [146, 662, 143, 666, 143, 666],
                [180, 693, 180, 694, 180, 693],
                [111, 687, 111, 688, 111, 687, 111, 688, 111, 687],
                [143, 666, 153, 667],
                [201, 711]
            ],
            "center": [183, 668],
            "bbox": [111, 624, 144, 88]
        }
    }
}
