{
    "layerExtent": [0.0, 0.0, 1000.0, 1000.0],
    "featureNames": ["7A2", "7A3", "7A4", "7A5", "7A6", "7A7", "7A1"],
    "features": {
        "7A2": {
            "shape": [
                [261, 690, 257, 692, 252, 692, 247, 690, 242, 690, 237, 690, 232, 691, 229, 693, 230, 696, 227, 699, 227, 702, 224, 704, 220, 704, 217, 706, 212, 704, 207, 704, 202, 708, 200, 711, 193, 710, 188, 709, 183, 707, 182, 700, 177, 697, 182, 696, 184, 697, 187, 695, 191, 696, 194, 695, 205, 693, 205, 683, 203, 688, 198, 693, 190, 694, 185, 693, 181, 692, 178, 692, 171, 692, 172, 696, 167, 691, 164, 689, 161, 687, 166, 688, 168, 684, 172, 681, 175, 681, 178, 681, 179, 677, 178, 673, 177, 669, 175, 666, 171, 665, 163, 665, 154, 666, 156, 661, 155, 658, 162, 657, 166, 654, 171, 651, 177, 648, 183, 648, 184, 642, 189, 638, 195, 639, 196, 644, 201, 642, 206, 638, 209, 640, 213, 639, 214, 636, 216, 634, 220, 633, 223, 631, 224, 627, 226, 624, 232, 626, 236, 622, 240, 621, 249, 622, 253, 621, 257, 619, 262, 615, 265, 613, 268, 611, 270, 608, 274, 610, 277, 608, 281, 606, 284, 604, 287, 602, 290, 600, 292, 597, 296, 594, 299, 590, 301, 587, 303, 582, 305, 579, 306, 574, 306, 569, 308, 566, 309, 562, 309, 557, 312, 554, 316, 555, 318, 552, 321, 552, 325, 553, 329, 551, 334, 552, 335, 558, 336, 564, 339, 566, 342, 564, 345, 562, 348, 562, 347, 566, 343, 567, 343, 571, 345, 574, 348, 576, 349, 579, 351, 584, 354, 586, 356, 589, 349, 590, 346, 593, 347, 597, 350, 601, 345, 604, 344, 606, 344, 610, 344, 613, 344, 618, 345, 622, 343, 625, 347, 627, 347, 630, 347, 633, 351, 634, 352, 637, 354, 640, 354, 643, 353, 646, 351, 649, 350, 651, 348, 654, 348, 657, 347, 659, 345, 662, 347, 665, 345, 669, 343, 672, 340, 674, 338, 677, 337, 681, 334, 681, 330, 680, 324, 680, 326, 684, 325, 686, 320, 686, 316, 687, 313, 685, 310, 688, 308, 691, 306, 694, 304, 698, 302, 701, 301, 704, 297, 705, 294, 707, 290, 707, 287, 705, 285, 702, 281, 701, 278, 703, 271, 701, 268, 699, 265, 692, 262, 696, 259, 694, 262, 692, 261, 690],
                [154, 688, 157, 686, 157, 693, 158, 692, 154, 688],
                [151, 665, 153, 668, 145, 665, 151, 665],
                [230, 706, 227, 705, 229, 705, 230, 706],
                [134, 686],
                [168, 666],
                [180, 694],
                [201, 711]
            ],
            "center": [245, 631],
            "bbox": [134, 551, 222, 161]
        },
        "7A3": {
            "shape": [
                [314, 717, 314, 720, 310, 721, 306, 720, 300, 721, 294, 720, 292, 723, 290, 724, 284, 724, 281, 723, 276, 721, 274, 720, 275, 716, 273, 713, 276, 711, 279, 709, 280, 705, 281, 703, 285, 703, 288, 705, 291, 707, 294, 706, 298, 705, 302, 704, 302, 700, 305, 698, 306, 693, 309, 691, 312, 687, 313, 686, 317, 687, 323, 686, 326, 686, 325, 682, 328, 680, 333, 680, 335, 683, 338, 685, 338, 688, 341, 690, 344, 688, 347, 685, 351, 684, 356, 686, 360, 686, 362, 693, 362, 698, 361, 702, 363, 705, 366, 708, 369, 712, 373, 715, 375, 718, 373, 721, 375, 724, 374, 729, 371, 731, 368, 733, 365, 735, 362, 735, 358, 736, 355, 738, 351, 737, 348, 737, 344, 736, 342, 733, 340, 730, 338, 725, 336, 722, 333, 720, 333, 717, 330, 715, 326, 714, 320, 714, 315, 714, 315, 715, 314, 717]
            ],
            "center": [323, 709],
            "bbox": [271, 680, 105, 58]
        },
        "7A4": {
            "shape": [
                [412, 745, 411, 749, 407, 752, 402, 752, 398, 753, 394, 752, 391, 754, 386, 754, 381, 754, 377, 753, 373, 752, 370, 752, 366, 751, 363, 749, 361, 746, 359, 743, 355, 741, 355, 738, 358, 736, 362, 735, 365, 735, 368, 733, 371, 731, 376, 731, 380, 733, 385, 732, 390, 732, 390, 728, 393, 726, 397, 725, 400, 727, 403, 725, 407, 724, 412, 724, 416, 725, 420, 727, 422, 730, 421, 732, 421, 736, 416, 739, 413, 743, 412, 745],
                [416, 755, 416, 754, 417, 754]
            ],
            "center": [388, 739],
            "bbox": [354, 724, 69, 31]
        },
        "7A5": {
            "shape": [
                [380, 679, 382, 676, 384, 680, 388, 681, 389, 683, 392, 685, 393, 690, 394, 693, 396, 696, 398, 699, 398, 703, 397, 707, 395, 708, 395, 713, 396, 716, 400, 720, 402, 722, 402, 725, 399, 727, 396, 726, 393, 727, 390, 729, 390, 732, 385, 732, 380, 733, 376, 731, 373, 729, 375, 725, 373, 722, 374, 718, 374, 715, 370, 712, 366, 709, 364, 706, 362, 703, 362, 700, 362, 695, 361, 690, 364, 688, 367, 686, 370, 684, 373, 682, 376, 680, 379, 678, 380, 679]
            ],
            "center": [382, 705],
            "bbox": [361, 676, 42, 58]
        },
        "7A6": {
            "shape": [
                [395, 682, 398, 679, 403, 680, 408, 681, 415, 680, 417, 677, 421, 675, 424, 673, 426, 670, 428, 667, 426, 663, 423, 660, 423, 657, 423, 653, 426, 652, 428, 655, 431, 658, 432, 662, 436, 661, 437, 665, 442, 664, 445, 662, 448, 660, 450, 661, 449, 664, 453, 665, 456, 667, 459, 669, 459, 672, 461, 675, 464, 677, 468, 676, 470, 677, 474, 678, 473, 682, 472, 684, 471, 688, 473, 691, 472, 695, 471, 697, 471, 700, 472, 702, 473, 706, 472, 708, 472, 711, 473, 715, 471, 720, 467, 721, 465, 725, 463, 729, 459, 729, 455, 732, 449, 731, 446, 732, 446, 731, 448, 729, 443, 729, 438, 729, 433, 730, 428, 732, 425, 734, 422, 734, 423, 731, 421, 728, 417, 725, 413, 724, 408, 724, 404, 725, 402, 722, 400, 720, 396, 716, 395, 713, 395, 709, 397, 706, 398, 704, 398, 699, 396, 696, 394, 693, 393, 690, 392, 685, 394, 684, 395, 682]
            ],
            "center": [433, 693],
            "bbox": [392, 652, 83, 83]
        },
        "7A7": {
            "shape": [
                [343, 672, 345, 669, 347, 665, 345, 662, 347, 659, 348, 657, 348, 654, 350, 651, 351, 649, 353, 646, 354, 643, 354, 640, 352, 637, 351, 634, 347, 633, 347, 630, 347, 627, 343, 626, 345, 623, 344, 619, 344, 614, 344, 611, 345, 607, 344, 604, 348, 601, 347, 599, 345, 593, 348, 591, 355, 589, 355, 586, 351, 585, 350, 580, 348, 577, 346, 574, 343, 572, 343, 568, 346, 566, 348, 563, 345, 561, 343, 564, 339, 565, 336, 565, 335, 561, 334, 553, 330, 552, 325, 550, 328, 548, 331, 546, 335, 545, 335, 542, 336, 540, 336, 535, 338, 532, 342, 533, 346, 532, 351, 533, 354, 529, 358, 529, 362, 528, 364, 525, 366, 522, 365, 520, 365, 516, 364, 512, 366, 508, 370, 506, 374, 505, 377, 503, 380, 501, 389, 499, 391, 496, 395, 497, 400, 498, 403, 501, 408, 501, 410, 498, 413, 496, 417, 495, 417, 499, 420, 502, 416, 504, 416, 508, 417, 512, 419, 514, 422, 514, 425, 514, 426, 518, 431, 519, 434, 520, 436, 522, 439, 525, 438, 525, 434, 526, 432, 529, 430, 532, 429, 535, 428, 538, 426, 540, 425, 544, 423, 547, 418, 551, 420, 554, 420, 557, 419, 559, 423, 556, 427, 554, 430, 552, 434, 551, 435, 555, 434, 560, 430, 561, 428, 564, 423, 564, 419, 565, 415, 566, 411, 567, 408, 571, 406, 574, 408, 577, 413, 579, 415, 582, 419, 583, 422, 585, 424, 588, 427, 590, 432, 590, 438, 589, 436, 594, 433, 596, 433, 599, 433, 602, 438, 602, 435, 605, 431, 605, 429, 607, 425, 609, 424, 613, 422, 616, 419, 620, 422, 622, 425, 622, 422, 624, 418, 625, 418, 628, 421, 630, 419, 633, 419, 636, 421, 639, 423, 642, 422, 645, 423, 649, 424, 652, 422, 655, 422, 658, 423, 662, 426, 664, 428, 669, 424, 670, 423, 674, 420, 676, 416, 678, 413, 680, 408, 680, 402, 680, 397, 680, 395, 683, 391, 684, 390, 682, 387, 681, 384, 678, 382, 678, 379, 678, 376, 679, 373, 681, 370, 683, 368, 686, 364, 687, 361, 690, 357, 686, 354, 684, 348, 685, 344, 687, 342, 689, 338, 689, 338, 686, 335, 684, 337, 681, 338, 677, 340, 674, 341, 672, 343, 672]
            ],
            "center": [382, 592],
            "bbox": [325, 495, 115, 195]
        },
        "7A1": {
            "shape": [
                [318, 430, 322, 431, 327, 430, 331, 429, 337, 426, 336, 425, 338, 424, 334, 420, 338, 419, 341, 421, 344, 421, 348, 422, 352, 425, 355, 427, 360, 427, 367, 427, 371, 426, 374, 424, 381, 420, 386, 420, 389, 418, 396, 417, 400, 416, 403, 418, 405, 423, 411, 421, 414, 423, 419, 427, 423, 430, 425, 433, 428, 435, 432, 436, 436, 438, 439, 440, 442, 443, 445, 446, 444, 450, 440, 451, 437, 453, 441, 456, 444, 458, 448, 459, 450, 460, 449, 462, 450, 464, 452, 468, 452, 474, 455, 477, 456, 480, 462, 480, 466, 481, 468, 485, 467, 488, 467, 491, 463, 492, 461, 495, 458, 495, 456, 492, 453, 488, 449, 487, 445, 488, 442, 488, 439, 484, 436, 486, 433, 488, 429, 491, 425, 491, 423, 492, 422, 496, 417, 495, 413, 496, 410, 498, 408, 501, 403, 501, 400, 498, 395, 497, 391, 497, 387, 500, 378, 501, 376, 504, 372, 505, 369, 507, 365, 510, 364, 514, 366, 517, 366, 521, 365, 523, 364, 527, 361, 529, 357, 530, 353, 531, 349, 532, 345, 533, 341, 532, 338, 534, 335, 538, 335, 541, 334, 543, 333, 545, 331, 548, 327, 548, 325, 552, 322, 552, 319, 552, 316, 554, 313, 554, 308, 555, 305, 549, 303, 546, 301, 543, 302, 539, 304, 536, 307, 532, 310, 530, 309, 522, 307, 518, 304, 516, 302, 513, 300, 510, 300, 507, 303, 503, 302, 499, 300, 496, 297, 492, 294, 490, 289, 490, 285, 491, 281, 492, 278, 494, 274, 493, 272, 494, 268, 496, 264, 497, 262, 500, 261, 502, 261, 507, 259, 510, 256, 512, 254, 509, 247, 505, 244, 507, 240, 508, 237, 508, 234, 508, 231, 511, 227, 508, 231, 503, 234, 499, 237, 497, 240, 494, 245, 489, 248, 487, 251, 485, 255, 484, 259, 483, 263, 481, 265, 477, 270, 475, 273, 473, 276, 470, 278, 467, 279, 463, 279, 458, 279, 455, 283, 453, 287, 451, 289, 448, 293, 446, 300, 439, 306, 435, 309, 433, 313, 431, 315, 429, 318, 421, 317, 423, 318, 430],
                [250, 422, 254, 421, 254, 417, 255, 412, 255, 409, 255, 405, 260, 404, 265, 404, 269, 404, 276, 403, 282, 404, 286, 405, 290, 408, 289, 411, 291, 414, 294, 417, 296, 422, 302, 423, 306, 422, 311, 422, 314, 422, 315, 425, 312, 427, 308, 432, 304, 435, 296, 439, 291, 445, 287, 450, 280, 453, 272, 451, 271, 449, 266, 447, 265, 444, 260, 443, 261, 438, 257, 435, 252, 433, 247, 429, 242, 425, 240, 423, 241, 419, 244, 419, 247, 422, 250, 422],
                [251, 402, 257, 403],
                [291, 410],
                [270, 401],
                [224, 515, 225, 514, 223, 517, 224, 515],
                [264, 508, 262, 509],
                [235, 511, 235, 510]
            ],
            "center": [345, 478],
            "bbox": [223, 401, 245, 155]
        }
    }
}
