{
    "layerExtent": [0.0, 0.0, 1000.0, 1000.0],
    "featureNames": ["DYF", "GWE", "CLD", "WGA", "SGA"],
    "features": {
        "DYF": {
            "shape": [
                [261, 690, 257, 692, 252, 692, 247, 690, 242, 690, 237, 690, 232, 691, 229, 693, 230, 696, 227, 699, 227, 702, 224, 704, 220, 704, 217, 706, 212, 704, 207, 704, 202, 708, 200, 711, 193, 710, 188, 709, 183, 707, 182, 700, 177, 697, 182, 696, 184, 697, 187, 695, 191, 696, 194, 695, 205, 693, 205, 683, 203, 688, 198, 693, 190, 694, 185, 693, 181, 692, 178, 692, 171, 692, 172, 696, 167, 691, 164, 689, 161, 687, 166, 688, 168, 684, 172, 681, 175, 681, 178, 681, 179, 677, 178, 673, 177, 669, 175, 666, 171, 665, 163, 665, 154, 666, 156, 661, 155, 658, 162, 657, 166, 654, 171, 651, 177, 648, 183, 648, 184, 642, 189, 638, 195, 639, 196, 644, 201, 642, 206, 638, 209, 640, 213, 639, 214, 636, 216, 634, 220, 633, 223, 631, 224, 627, 226, 624, 232, 626, 236, 622, 240, 621, 249, 622, 253, 621, 257, 619, 262, 615, 265, 613, 268, 611, 270, 608, 274, 610, 277, 608, 281, 606, 284, 604, 287, 602, 290, 600, 292, 597, 296, 594, 299, 590, 301, 587, 303, 582, 305, 579, 306, 574, 306, 569, 308, 566, 309, 562, 309, 557, 312, 554, 316, 555, 318, 552, 321, 552, 325, 553, 329, 551, 334, 552, 335, 558, 336, 564, 339, 566, 342, 564, 345, 562, 348, 562, 347, 566, 343, 567, 343, 571, 345, 574, 348, 576, 349, 579, 351, 584, 354, 586, 356, 589, 349, 590, 346, 593, 347, 597, 350, 601, 345, 604, 344, 606, 344, 610, 344, 613, 344, 618, 345, 622, 343, 625, 347, 627, 347, 630, 347, 633, 351, 634, 352, 637, 354, 640, 354, 643, 353, 646, 351, 649, 350, 651, 348, 654, 348, 657, 347, 659, 345, 662, 347, 665, 345, 669, 343, 672, 340, 674, 338, 677, 337, 681, 334, 681, 330, 680, 324, 680, 326, 684, 325, 686, 320, 686, 316, 687, 313, 685, 310, 688, 308, 691, 306, 694, 304, 698, 302, 701, 301, 704, 297, 705, 294, 707, 290, 707, 287, 705, 285, 702, 281, 701, 278, 703, 271, 701, 268, 699, 265, 692, 262, 696, 259, 694, 262, 692, 261, 690],
                [154, 688, 157, 686, 157, 693, 158, 692, 154, 688],
                [151, 665, 153, 668, 145, 665, 151, 665],
                [230, 706, 227, 705, 229, 705, 230, 706],
                [134, 686],
                [168, 666],
                [180, 694],
                [201, 711]
            ],
            "center": [245, 631],
            "bbox": [134, 551, 222, 161]
        },
        "GWE": {
            "shape": [
                [395, 682, 398, 679, 403, 680, 408, 681, 415, 680, 417, 677, 421, 675, 424, 673, 426, 670, 428, 667, 426, 663, 423, 660, 423, 657, 423, 653, 426, 652, 428, 655, 431, 658, 432, 662, 436, 661, 437, 665, 442, 664, 445, 662, 448, 660, 450, 661, 449, 664, 453, 665, 456, 667, 459, 669, 459, 672, 461, 675, 464, 677, 468, 676, 470, 677, 474, 678, 473, 682, 472, 684, 471, 688, 473, 691, 472, 695, 471, 697, 471, 700, 472, 702, 473, 706, 472, 708, 472, 711, 473, 715, 471, 720, 467, 721, 465, 725, 463, 729, 459, 729, 455, 732, 449, 731, 446, 732, 446, 731, 448, 729, 443, 729, 438, 729, 433, 730, 428, 732, 425, 734, 422, 734, 423, 731, 421, 728, 417, 725, 413, 724, 408, 724, 404, 725, 402, 722, 400, 720, 396, 716, 395, 713, 395, 709, 397, 706, 398, 704, 398, 699, 396, 696, 394, 693, 393, 690, 392, 685, 394, 684, 395, 682]
            ],
            "center": [433, 693],
            "bbox": [392, 652, 83, 83]
        },
        "CLD": {
            "shape": [
                [318, 430, 322, 431, 327, 430, 331, 429, 337, 426, 336, 425, 338, 424, 334, 420, 338, 419, 341, 421, 344, 421, 348, 422, 352, 425, 355, 427, 360, 427, 367, 427, 371, 426, 374, 424, 381, 420, 386, 420, 389, 418, 396, 417, 400, 416, 403, 418, 405, 423, 411, 421, 414, 423, 419, 427, 423, 430, 425, 433, 428, 435, 432, 436, 436, 438, 439, 440, 442, 443, 445, 446, 444, 450, 440, 451, 437, 453, 441, 456, 444, 458, 448, 459, 450, 460, 449, 462, 450, 464, 452, 468, 452, 474, 455, 477, 456, 480, 462, 480, 466, 481, 468, 485, 467, 488, 467, 491, 463, 492, 461, 495, 458, 495, 456, 492, 453, 488, 449, 487, 445, 488, 442, 488, 439, 484, 436, 486, 433, 488, 429, 491, 425, 491, 423, 492, 422, 496, 419, 498, 420, 500, 418, 503, 417, 507, 415, 511, 417, 514, 421, 515, 424, 513, 426, 516, 429, 518, 433, 519, 434, 522, 436, 524, 437, 527, 436, 526, 432, 527, 431, 531, 430, 534, 429, 538, 425, 539, 426, 542, 424, 546, 420, 549, 419, 553, 421, 556, 418, 558, 425, 558, 426, 555, 429, 553, 432, 551, 435, 553, 434, 558, 431, 560, 430, 564, 425, 564, 420, 564, 417, 566, 413, 568, 409, 570, 406, 572, 407, 576, 410, 578, 415, 580, 417, 583, 421, 584, 423, 587, 426, 589, 430, 590, 436, 589, 437, 593, 434, 595, 434, 598, 432, 601, 436, 603, 436, 605, 432, 604, 429, 606, 427, 609, 424, 611, 421, 614, 420, 619, 420, 622, 424, 621, 423, 623, 420, 625, 416, 627, 421, 629, 419, 631, 418, 635, 420, 638, 422, 641, 422, 644, 423, 647, 425, 651, 423, 653, 423, 657, 423, 660, 426, 663, 428, 667, 426, 670, 424, 673, 421, 675, 417, 677, 415, 680, 409, 681, 404, 681, 398, 678, 395, 681, 393, 684, 389, 683, 388, 681, 384, 680, 382, 676, 380, 679, 376, 677, 375, 681, 371, 682, 368, 684, 365, 686, 363, 689, 358, 687, 355, 685, 350, 685, 345, 686, 343, 689, 340, 689, 339, 687, 336, 685, 336, 682, 338, 679, 339, 675, 341, 672, 345, 670, 347, 667, 345, 663, 347, 660, 347, 657, 348, 655, 350, 652, 350, 649, 353, 647, 353, 643, 355, 640, 352, 638, 351, 635, 348, 633, 347, 631, 347, 628, 344, 626, 345, 624, 344, 620, 345, 615, 345, 611, 344, 608, 344, 605, 347, 601, 348, 598, 346, 595, 347, 591, 354, 589, 355, 587, 352, 585, 350, 581, 349, 577, 347, 574, 344, 572, 344, 568, 346, 567, 347, 563, 346, 561, 343, 563, 340, 565, 337, 565, 335, 562, 335, 553, 331, 552, 325, 552, 322, 552, 319, 552, 316, 554, 313, 554, 308, 555, 305, 549, 303, 546, 301, 543, 302, 539, 304, 536, 307, 532, 310, 530, 309, 522, 307, 518, 304, 516, 302, 513, 300, 510, 300, 507, 303, 503, 302, 499, 300, 496, 297, 492, 294, 490, 289, 490, 285, 491, 281, 492, 278, 494, 274, 493, 272, 494, 268, 496, 264, 497, 262, 500, 261, 502, 261, 507, 259, 510, 256, 512, 254, 509, 247, 505, 244, 507, 240, 508, 237, 508, 234, 508, 231, 511, 227, 508, 231, 503, 234, 499, 237, 497, 240, 494, 245, 489, 248, 487, 251, 485, 255, 484, 259, 483, 263, 481, 265, 477, 270, 475, 273, 473, 276, 470, 278, 467, 279, 463, 279, 458, 279, 455, 283, 453, 287, 451, 289, 448, 293, 446, 300, 439, 306, 435, 309, 433, 313, 431, 315, 429, 318, 421, 317, 423, 318, 430],
                [250, 422, 254, 421, 254, 417, 255, 412, 255, 409, 255, 405, 260, 404, 265, 404, 269, 404, 276, 403, 282, 404, 286, 405, 290, 408, 289, 411, 291, 414, 294, 417, 296, 422, 302, 423, 306, 422, 311, 422, 314, 422, 315, 425, 312, 427, 308, 432, 304, 435, 296, 439, 291, 445, 287, 450, 280, 453, 272, 451, 271, 449, 266, 447, 265, 444, 260, 443, 261, 438, 257, 435, 252, 433, 247, 429, 242, 425, 240, 423, 241, 419, 244, 419, 247, 422, 250, 422],
                [251, 402, 257, 403],
                [291, 410],
                [270, 401],
                [224, 515, 225, 514, 223, 517, 224, 515],
                [264, 508, 262, 509],
                [235, 511, 235, 510]
            ],
            "center": [345, 545],
            "bbox": [223, 401, 245, 289]
        },
        "WGA": {
            "shape": [
                [314, 717, 314, 720, 310, 721, 306, 720, 300, 721, 294, 720, 292, 723, 290, 724, 284, 724, 281, 723, 276, 721, 274, 720, 275, 716, 273, 713, 276, 711, 279, 709, 280, 705, 281, 703, 285, 703, 288, 705, 291, 707, 294, 706, 298, 705, 302, 704, 302, 700, 305, 698, 306, 693, 309, 691, 312, 687, 313, 686, 317, 687, 323, 686, 326, 686, 325, 682, 328, 680, 333, 680, 335, 683, 338, 685, 338, 688, 341, 690, 344, 688, 347, 685, 351, 684, 356, 686, 360, 686, 362, 693, 362, 698, 361, 702, 363, 705, 366, 708, 369, 712, 373, 715, 375, 718, 373, 721, 375, 724, 374, 729, 371, 731, 368, 733, 365, 735, 362, 735, 358, 736, 355, 738, 351, 737, 348, 737, 344, 736, 342, 733, 340, 730, 338, 725, 336, 722, 333, 720, 333, 717, 330, 715, 326, 714, 320, 714, 315, 714, 315, 715, 314, 717]
            ],
            "center": [323, 709],
            "bbox": [271, 680, 105, 58]
        },
        "SGA": {
            "shape": [
                [412, 745, 411, 749, 407, 752, 402, 752, 398, 753, 394, 752, 391, 754, 386, 754, 381, 754, 377, 753, 373, 752, 370, 752, 366, 751, 363, 749, 361, 746, 359, 743, 355, 741, 355, 738, 358, 736, 362, 735, 365, 735, 368, 733, 373, 730, 376, 726, 374, 722, 374, 719, 374, 716, 370, 713, 368, 710, 364, 707, 362, 704, 361, 701, 362, 696, 361, 691, 363, 688, 366, 686, 369, 684, 372, 682, 375, 680, 378, 678, 382, 678, 384, 678, 387, 681, 390, 682, 391, 684, 393, 688, 395, 692, 396, 693, 397, 698, 399, 702, 398, 706, 396, 707, 395, 711, 395, 714, 398, 719, 400, 723, 403, 724, 407, 724, 412, 724, 416, 725, 420, 727, 422, 730, 421, 732, 421, 736, 416, 739, 413, 743, 412, 745],
                [416, 755, 416, 754, 417, 754]
            ],
            "center": [388, 715],
            "bbox": [354, 676, 69, 79]
        }
    }
}
